"filename", "language", "C++", "comment", "blank", "total"
"/home/ccz/workspace/MyTinyWebServer/include/CGIMysql/sqlConnectionPool.h", "C++", 34, 1, 12, 47
"/home/ccz/workspace/MyTinyWebServer/include/config/default.config.h", "C++", 1, 0, 1, 2
"/home/ccz/workspace/MyTinyWebServer/include/lock/locker.h", "C++", 76, 0, 17, 93
"/home/ccz/workspace/MyTinyWebServer/include/log/blockQueue.h", "C++", 94, 5, 16, 115
"/home/ccz/workspace/MyTinyWebServer/include/log/log.h", "C++", 7, 0, 2, 9
"/home/ccz/workspace/MyTinyWebServer/include/threadpool/threadpool.h", "C++", 6, 1, 1, 8
"/home/ccz/workspace/MyTinyWebServer/include/webserver/webserver.h", "C++", 11, 0, 2, 13
"/home/ccz/workspace/MyTinyWebServer/main.cpp", "C++", 0, 0, 1, 1
"/home/ccz/workspace/MyTinyWebServer/src/CGIMysql/sqlConnectionPool.cpp", "C++", 34, 1, 5, 40
"/home/ccz/workspace/MyTinyWebServer/src/lock/locker.h", "C++", 79, 0, 18, 97
"/home/ccz/workspace/MyTinyWebServer/src/threadpool/threadpool.h", "C++", 6, 1, 1, 8
"/home/ccz/workspace/MyTinyWebServer/src/webserver/webserver.h", "C++", 11, 0, 2, 13
"Total", "-", 359, 9, 78, 446